#implementign shell like comments to be ignored.

#INDETIFIERS
NO	textures/barrel.xpm
SO	textures/bluestone.xpm
WE	textures/colorstone.xpm
EA	textures/eagle.xpm
F	28,255,	3
C		7, 255, 40
C		7, 255, 40
C		7, 255, 40

#will make it so that '\t' is replaced by (4-(number of characters in line so far)%4)

#this should be a valid(although shitty, made by a total asshole) map. Note the trailing spaces/tabs.
        11111111
        1000000111111111111111
        1000000100000000000001
        1000001000000000000101
        1000000100000000000001
111111111111011100000000000001
100000000000000000000111111111
10000000000000000000000000001
10000000000000000000000000001
11110111110000000000000000001
10000000000000000S00000000001
10000000010000010000011111111
10000000010000010000000000001111
10000000010000010000000000000001
11111111111111111111111111111111
