#implementign shell like comments to be ignored.

#INDETIFIERS
NO	textures/barrel.xpm
SO	textures/bluestone.xpm
WE	textures/colorstone.xpm
EA	textures/eagle.xpm
F	28,255,	3
C		7, 255, 40
C		7, 255, 40
C		7, 255, 40

#will make it so that '\t' is replaced by (4-(number of characters in line so far)%4)

#this should be a valid(although shitty, made by a total asshole) map. Note the trailing spaces/tabs.
             1 1 1 1 1 1 1 1 1 1 1
            1111111111111111111111111                 111111111
            100000000011000000000000111111111111111111100000001
            1011000001110000000000000000000000000000000000000011
            10010000000000000000000011111111111111111110000000011
    111111111011000001110000000000001                 10111111111
    10000000001100000111011111111111111111111         111
    11110111111111011100000010001           1
111111110111111111011101010010001           1       111111111
100000000000110101011100S00010001           1       100000001
111110000000000000001100000010001           1       100000001
    10000000000000001101010010001        1111       100000001
    1100000111010101111101111000111                 110000011
    11110111 1110101 101111010001                    1100011
    11111111 1111111 111111111011                     11011
                             101                       111
                             101
                             101
                             101
                             101
                            11011
                11111111111110001111111
                10000000000000000000001
                10011111111111111110001
                1001              10001
                10011111111111111110001
                10000000000000000000001
                11111111111111111111111
