#INDETIFIERS
NO	./textures/uni1.xpm
SO	./textures/uni2.xpm
WE	./textures/uni3.xpm
EA	./textures/unipoop.xpm
F   209, 165, 190
C   53, 164, 166

11111111111111111111111111111
10000000001100000000000000001
10110000011101000000000010101
10010000000000000000000010001
10110000011100000000000010001
10000000001100000111011110001
11110111111111011100000010001
11110111111111011101010010001
11000000110101011100000010001
10001000000000001100000010001
10000000000000001101010010001
11010000110101000000000000001
11110111110101000000000000001
10000000001100000100100010001
100000000000000010N0000101001
10100000001000010001010001001
10000000001101000100000100101
10000000000100000001010000001
11111111111111111111111111111
